Controle	int
Data	datetime
LkTipo	int
Nota	int
Serie	varchar
Pedido	int
LkReceb	int
LkVendedor	int
LkCliente	int
LkFornec	int
TagCliente	int
Comissao	float
Obs	varchar
Venda	bit
LkUser	int
CFOP	varchar
Cancelada	bit
TipoDoc	varchar
LkOrca	int
Cliente	varchar
Endereco	varchar
Bairro	varchar
Cidade	varchar
UF	varchar
TOTAL	float
DESCONTO	float
ACRESCIMO	float
SUBTOTAL	float
VLPAGO	float
Entrada	float
Faturado	float
Km	int
Placa	varchar
HoraIni	varchar
HoraFim	varchar
Descricao	varchar
LkTurno	int
DataTurno	datetime
DataSaida	datetime
Venda_Servico	varchar
idEmpresa	int
Contrato	int
Cupom	int
LkECF	int
QtdItens	int
DataEntrega	datetime
RG_INSC	varchar
CPF_CNPJ	varchar
IdControle	int
Vendedor	varchar
Status	char
bloqueado	int
LkCaixa	int
LkUsuario	int
Saldo_limite	float
VlBonus	float
ComplEnd	varchar
Telefone	varchar
eMail	varchar
lkConvenio	int
ComissaoItemValor	float
ComissaoNota	float
Codigo	varchar
ORCAMENTO	int
LkCxFecha	int
LkAtendente	int
Numero	varchar
LkEntregador	int
LkFidelidade	int
Num_Mod_Doc	int
Chave_Acesso	varchar
nProt	varchar
NFCe_Data	datetime
NFCe_enviada	int
Cod_Mun	int
CEP	varchar
DescRateioPer	float
AcrescRateioPer	float
TotalServico	float
LkEntregaTx	int
VlEntregaTx	float
TrocoPara	float
MesaComanda	int
DtUltAtualizacao	datetime
LkBiometria	int
FlagIntegra	int